R 99999 99999

NO     /Users/han_woori/Desktop/cub3d/taelee/textures/wall_n.xpm

WE    /Users/han_woori/Desktop/cub3d/my/textures/wood.xpm

EA   /Users/han_woori/Desktop/cub3d/my/textures/eagle.xpm

SO  /Users/han_woori/Desktop/cub3d/taelee/textures/wall_s.xpm

S   /Users/han_woori/Desktop/cub3d/my/textures/barrel.xpm

F 222,184,135

C 135,206,250




        1111111111111111111111111
        1000000000110000000000001
        1011000001110000000000001
        1001000000000000000000001
111111111000000000000000000000001
100000000000000020000000200111111
10000000002000000000000000001
10000200000000000000000000001
10000000000000000000000000001
10000000000000000000000000001
10000000000000000000000000001
10000000000000000000000000001
10000000000000000000000000001
10000000000000000000000000001
10000000000000000000000000001
10000000000000000000000000001
11000001110000011100000000N01
11110111 1110101 101111010001
11111111 1111111 111111111111