R 500 500
NO ./
SO ./
WE ./
EA ./

S ./
F
C


       1111
11101000001
  100000001
   10000001
    1111111

    11111111
111100000001
1000000001
100000
11111
